8
########
#  . . #
#    # #
## # # #
 #  $  #
 #  $@ #
 #     #
 #######
