11
 #########
 #   *   #
 # ## ## #
 #  * *  #
###  #  ###
#  .$#$.  #
# #  @  # #
#  .$#$.  #
###  #  ###
  #######
