7
   ####
 ###  #
 #@ .$##
 #   $ #
 # #.  #
 #     #
 #######
